"Data operacji","Data waluty","Typ transakcji","Kwota","Waluta","Saldo po transakcji","Opis transakcji","","","",""
"2023-05-11","2023-05-11",Op³ata za u¿ytkowanie karty,-3.00,"PLN",+87.00,OP£ATA ZA KARTÊ,"","","",""
"2023-05-08","2023-05-08","Przelew na rachunek",+10.00,"PLN",+90.00,Rachunek nadawcy: X,Nazwa nadawcy: Adam,"","",""
"2023-05-08","2023-05-08","Przelew na rachunek",+10.00,"PLN",+80.00,Rachunek nadawcy: X,Nazwa nadawcy: Artur,"","",""
"2023-05-06","2023-05-06",Przelew na rachunek,+10.00,"PLN",+70.00,Rachunek nadawcy: X,Nazwa nadawcy: Anna,"","",""
"2023-05-04","2023-05-04",Obci¹¿enie,-40.00,"PLN",+60.00,Tytu³: PIZZA ITALIANA,"","","",""
2023-05-03,2023-05-03,Przelew na rachunek,+100.00,"PLN",+100.00,Tytu³: WYNAGRODZENIE,"","","",""
